11111111111111111111
10000000000000000001
10000000000000000001
10001100000000000001
10001100000000000001
10001100000000000001
10001100000000000001
10000000000100000001
10000000000000000001
10000000000000000001
10000000000000010001
10000000000000000001
10001000011000000001
10000000011000000001
10000000011000000001
10000000011000000001
10000000000000010001
10000000000000000001
10000000000000000001
11111111111111111111
